@wxywwyxywxwywwwxywx
waaaaaaaaaaaaaaaaaaw
y..................w
w..................y
x.........S........z
w.........S........z
w.........S........z
x.....SSSSSSSSS....z
y.........S........z
x.........S........x
x.........S........y
w..................w
y..................x
wywxyxwyyxwwyxwwxywy
....................