@wwywwwywwwwywwwwyww
w..................y
w..........E.......w
w..................w
w..................w
w..................w
w..................D
w..................D
w..................w
w..................w
y..................w
w..................w
w..................w
wwwwwwwwwwwwwwwwwwwy